CYBB	Diabetes_patway	KEGG
AMCBX2	Diabetes_patway	KEGG
CGD	Diabetes_patway	KEGG
GP91-1	Diabetes_patway	KEGG
GP91-PHOX	Diabetes_patway	KEGG
GP91PHOX	Diabetes_patway	KEGG
IMD34	Diabetes_patway	KEGG
NOX2	Diabetes_patway	KEGG
p91-PHOX	Diabetes_patway	KEGG
AGER	Diabetes_patway	KEGG
RAGE	Diabetes_patway	KEGG
SCARJ1	Diabetes_patway	KEGG
NFKB1	Diabetes_patway	KEGG
CVID12	Diabetes_patway	KEGG
EBP-1	Diabetes_patway	KEGG
KBF1	Diabetes_patway	KEGG
NF-kB	Diabetes_patway	KEGG
NF-kB1	Diabetes_patway	KEGG
NF-kappa-B1	Diabetes_patway	KEGG
NF-kappaB	Diabetes_patway	KEGG
NFKB-p105	Diabetes_patway	KEGG
NFKB-p50	Diabetes_patway	KEGG
NFkappaB	Diabetes_patway	KEGG
p105	Diabetes_patway	KEGG
p50	Diabetes_patway	KEGG
PRKCB	Diabetes_patway	KEGG
PKC-beta	Diabetes_patway	KEGG
PKCB	Diabetes_patway	KEGG
PKCI(2)	Diabetes_patway	KEGG
PKCbeta	Diabetes_patway	KEGG
PRKCB1	Diabetes_patway	KEGG
PRKCB2	Diabetes_patway	KEGG
MAPK8	Diabetes_patway	KEGG
JNK	Diabetes_patway	KEGG
JNK-46	Diabetes_patway	KEGG
JNK1	Diabetes_patway	KEGG
JNK1A2	Diabetes_patway	KEGG
JNK21B1/2	Diabetes_patway	KEGG
PRKM8	Diabetes_patway	KEGG
SAPK1	Diabetes_patway	KEGG
SAPK1c	Diabetes_patway	KEGG
EGR1	Diabetes_patway	KEGG
AT225	Diabetes_patway	KEGG
G0S30	Diabetes_patway	KEGG
KROX-24	Diabetes_patway	KEGG
NGFI-A	Diabetes_patway	KEGG
TIS8	Diabetes_patway	KEGG
ZIF-268	Diabetes_patway	KEGG
ZNF225	Diabetes_patway	KEGG
HRAS	Diabetes_patway	KEGG
C-BAS/HAS	Diabetes_patway	KEGG
C-H-RAS	Diabetes_patway	KEGG
C-HA-RAS1	Diabetes_patway	KEGG
CTLO	Diabetes_patway	KEGG
H-RASIDX	Diabetes_patway	KEGG
HAMSV	Diabetes_patway	KEGG
HRAS1	Diabetes_patway	KEGG
RASH1	Diabetes_patway	KEGG
p21ras	Diabetes_patway	KEGG
MAPK14	Diabetes_patway	KEGG
CSBP	Diabetes_patway	KEGG
CSBP1	Diabetes_patway	KEGG
CSBP2	Diabetes_patway	KEGG
CSPB1	Diabetes_patway	KEGG
EXIP	Diabetes_patway	KEGG
Mxi2	Diabetes_patway	KEGG
PRKM14	Diabetes_patway	KEGG
PRKM15	Diabetes_patway	KEGG
RK	Diabetes_patway	KEGG
SAPK2A	Diabetes_patway	KEGG
p38	Diabetes_patway	KEGG
p38ALPHA	Diabetes_patway	KEGG
MAPK1	Diabetes_patway	KEGG
ERK	Diabetes_patway	KEGG
ERK-2	Diabetes_patway	KEGG
ERK2	Diabetes_patway	KEGG
ERT1	Diabetes_patway	KEGG
MAPK2	Diabetes_patway	KEGG
P42MAPK	Diabetes_patway	KEGG
PRKM1	Diabetes_patway	KEGG
PRKM2	Diabetes_patway	KEGG
p40	Diabetes_patway	KEGG
p41	Diabetes_patway	KEGG
p41mapk	Diabetes_patway	KEGG
p42-MAPK	Diabetes_patway	KEGG
TGFB2	Diabetes_patway	KEGG
G-TSF	Diabetes_patway	KEGG
LDS4	Diabetes_patway	KEGG
TGF-beta2	Diabetes_patway	KEGG
TGFBR1	Diabetes_patway	KEGG
AAT5	Diabetes_patway	KEGG
ACVRLK4	Diabetes_patway	KEGG
ALK-5	Diabetes_patway	KEGG
ALK5	Diabetes_patway	KEGG
ESS1	Diabetes_patway	KEGG
LDS1	Diabetes_patway	KEGG
LDS1A	Diabetes_patway	KEGG
LDS2A	Diabetes_patway	KEGG
MSSE	Diabetes_patway	KEGG
SKR4	Diabetes_patway	KEGG
TBR-i	Diabetes_patway	KEGG
TBRI	Diabetes_patway	KEGG
TGFR-1	Diabetes_patway	KEGG
tbetaR-I	Diabetes_patway	KEGG
TGFBR2	Diabetes_patway	KEGG
AAT3	Diabetes_patway	KEGG
FAA3	Diabetes_patway	KEGG
LDS1B	Diabetes_patway	KEGG
LDS2	Diabetes_patway	KEGG
LDS2B	Diabetes_patway	KEGG
MFS2	Diabetes_patway	KEGG
RIIC	Diabetes_patway	KEGG
TAAD2	Diabetes_patway	KEGG
TBR-ii	Diabetes_patway	KEGG
TBRII	Diabetes_patway	KEGG
TGFR-2	Diabetes_patway	KEGG
TGFbeta-RII	Diabetes_patway	KEGG
SMAD2	Diabetes_patway	KEGG
JV18	Diabetes_patway	KEGG
JV18-1	Diabetes_patway	KEGG
MADH2	Diabetes_patway	KEGG
MADR2	Diabetes_patway	KEGG
hMAD-2	Diabetes_patway	KEGG
hSMAD2	Diabetes_patway	KEGG
SMAD4	Diabetes_patway	KEGG
DPC4	Diabetes_patway	KEGG
JIP	Diabetes_patway	KEGG
MADH4	Diabetes_patway	KEGG
MYHRS	Diabetes_patway	KEGG
EDN1	Diabetes_patway	KEGG
ARCND3	Diabetes_patway	KEGG
ET1	Diabetes_patway	KEGG
HDLCQ7	Diabetes_patway	KEGG
PPET1	Diabetes_patway	KEGG
QME	Diabetes_patway	KEGG
F3	Diabetes_patway	KEGG
CD142	Diabetes_patway	KEGG
TF	Diabetes_patway	KEGG
TFA	Diabetes_patway	KEGG
THBD	Diabetes_patway	KEGG
AHUS6	Diabetes_patway	KEGG
BDCA3	Diabetes_patway	KEGG
CD141	Diabetes_patway	KEGG
THPH12	Diabetes_patway	KEGG
THRM	Diabetes_patway	KEGG
TM	Diabetes_patway	KEGG
IL1A	Diabetes_patway	KEGG
IL-1_alpha	Diabetes_patway	KEGG
IL-1A	Diabetes_patway	KEGG
IL1	Diabetes_patway	KEGG
IL1-ALPHA	Diabetes_patway	KEGG
IL1F1	Diabetes_patway	KEGG
IL6	Diabetes_patway	KEGG
BSF-2	Diabetes_patway	KEGG
BSF2	Diabetes_patway	KEGG
CDF	Diabetes_patway	KEGG
HGF	Diabetes_patway	KEGG
HSF	Diabetes_patway	KEGG
IFN-beta-2	Diabetes_patway	KEGG
IFNB2	Diabetes_patway	KEGG
IL-6	Diabetes_patway	KEGG
TNF	Diabetes_patway	KEGG
DIF	Diabetes_patway	KEGG
TNF-alpha	Diabetes_patway	KEGG
TNFA	Diabetes_patway	KEGG
TNFSF2	Diabetes_patway	KEGG
TNLG1F	Diabetes_patway	KEGG
VCAM1	Diabetes_patway	KEGG
CD106	Diabetes_patway	KEGG
INCAM-100	Diabetes_patway	KEGG
ICAM1	Diabetes_patway	KEGG
BB2	Diabetes_patway	KEGG
CD54	Diabetes_patway	KEGG
P3.58	Diabetes_patway	KEGG
CXCL8	Diabetes_patway	KEGG
GCP-1	Diabetes_patway	KEGG
GCP1	Diabetes_patway	KEGG
IL8	Diabetes_patway	KEGG
LECT	Diabetes_patway	KEGG
LUCT	Diabetes_patway	KEGG
LYNAP	Diabetes_patway	KEGG
MDNCF	Diabetes_patway	KEGG
MONAP	Diabetes_patway	KEGG
NAF	Diabetes_patway	KEGG
NAP-1	Diabetes_patway	KEGG
NAP1	Diabetes_patway	KEGG
JUN	Diabetes_patway	KEGG
AP-1	Diabetes_patway	KEGG
AP1	Diabetes_patway	KEGG
c-Jun	Diabetes_patway	KEGG
cJUN	Diabetes_patway	KEGG
p39	Diabetes_patway	KEGG
JAK2	Diabetes_patway	KEGG
JTK10	Diabetes_patway	KEGG
THCYT3	Diabetes_patway	KEGG
STAT5A	Diabetes_patway	KEGG
MGF	Diabetes_patway	KEGG
STAT5	Diabetes_patway	KEGG
CCND1	Diabetes_patway	KEGG
BCL1	Diabetes_patway	KEGG
D11S287E	Diabetes_patway	KEGG
PRAD1	Diabetes_patway	KEGG
U21B31	Diabetes_patway	KEGG
CDK4	Diabetes_patway	KEGG
CMM3	Diabetes_patway	KEGG
PSK-J3	Diabetes_patway	KEGG
STAT1	Diabetes_patway	KEGG
CANDF7	Diabetes_patway	KEGG
IMD31A	Diabetes_patway	KEGG
IMD31B	Diabetes_patway	KEGG
IMD31C	Diabetes_patway	KEGG
ISGF-3	Diabetes_patway	KEGG
STAT91	Diabetes_patway	KEGG
BAX	Diabetes_patway	KEGG
BCL2L4	Diabetes_patway	KEGG
BCL2	Diabetes_patway	KEGG
Bcl-2	Diabetes_patway	KEGG
PPP1R50	Diabetes_patway	KEGG
CASP3	Diabetes_patway	KEGG
CPP32	Diabetes_patway	KEGG
CPP32B	Diabetes_patway	KEGG
SCA-1	Diabetes_patway	KEGG
AKT3	Diabetes_patway	KEGG
MPPH	Diabetes_patway	KEGG
MPPH2	Diabetes_patway	KEGG
PKB-GAMMA	Diabetes_patway	KEGG
PKBG	Diabetes_patway	KEGG
PRKBG	Diabetes_patway	KEGG
RAC-PK-gamma	Diabetes_patway	KEGG
RAC-gamma	Diabetes_patway	KEGG
STK-2	Diabetes_patway	KEGG
DIAPH1	Diabetes_patway	KEGG
DFNA1	Diabetes_patway	KEGG
DIA1	Diabetes_patway	KEGG
DRF1	Diabetes_patway	KEGG
LFHL1	Diabetes_patway	KEGG
SCBMS	Diabetes_patway	KEGG
hDIA1	Diabetes_patway	KEGG
COL1A1	Diabetes_patway	KEGG
CAFYD	Diabetes_patway	KEGG
EDSARTH1	Diabetes_patway	KEGG
EDSC	Diabetes_patway	KEGG
OI1	Diabetes_patway	KEGG
OI2	Diabetes_patway	KEGG
OI3	Diabetes_patway	KEGG
OI4	Diabetes_patway	KEGG
PIK3CA	Diabetes_patway	KEGG
CLAPO	Diabetes_patway	KEGG
CLOVE	Diabetes_patway	KEGG
CWS5	Diabetes_patway	KEGG
MCAP	Diabetes_patway	KEGG
MCM	Diabetes_patway	KEGG
MCMTC	Diabetes_patway	KEGG
PI3K	Diabetes_patway	KEGG
PI3K-alpha	Diabetes_patway	KEGG
p110-alpha	Diabetes_patway	KEGG
NOS3	Diabetes_patway	KEGG
ECNOS	Diabetes_patway	KEGG
eNOS	Diabetes_patway	KEGG
FOXO1	Diabetes_patway	KEGG
FKH1	Diabetes_patway	KEGG
FKHR	Diabetes_patway	KEGG
FOXO1A	Diabetes_patway	KEGG
RAC1	Diabetes_patway	KEGG
MIG5	Diabetes_patway	KEGG
MRD48	Diabetes_patway	KEGG
Rac-1	Diabetes_patway	KEGG
TC-25	Diabetes_patway	KEGG
p21-Rac1	Diabetes_patway	KEGG
STAT3	Diabetes_patway	KEGG
ADMIO	Diabetes_patway	KEGG
ADMIO1	Diabetes_patway	KEGG
APRF	Diabetes_patway	KEGG
HIES	Diabetes_patway	KEGG
PIM1	Diabetes_patway	KEGG
PIM	Diabetes_patway	KEGG
NFATC1	Diabetes_patway	KEGG
NF-ATC	Diabetes_patway	KEGG
NF-ATc1.2	Diabetes_patway	KEGG
NFAT2	Diabetes_patway	KEGG
NFATc	Diabetes_patway	KEGG
VEGFD	Diabetes_patway	KEGG
FIGF	Diabetes_patway	KEGG
VEGF-D	Diabetes_patway	KEGG
CCL2	Diabetes_patway	KEGG
GDCF-2	Diabetes_patway	KEGG
HC11	Diabetes_patway	KEGG
HSMCR30	Diabetes_patway	KEGG
MCAF	Diabetes_patway	KEGG
MCP-1	Diabetes_patway	KEGG
MCP1	Diabetes_patway	KEGG
SCYA2	Diabetes_patway	KEGG
SMC-CF	Diabetes_patway	KEGG
SERPINE1	Diabetes_patway	KEGG
PAI	Diabetes_patway	KEGG
PAI-1	Diabetes_patway	KEGG
PAI1	Diabetes_patway	KEGG
PLANH1	Diabetes_patway	KEGG
MMP2	Diabetes_patway	KEGG
CLG4	Diabetes_patway	KEGG
CLG4A	Diabetes_patway	KEGG
MMP-2	Diabetes_patway	KEGG
MMP-II	Diabetes_patway	KEGG
MONA	Diabetes_patway	KEGG
TBE-1	Diabetes_patway	KEGG
SELE	Diabetes_patway	KEGG
CD62E	Diabetes_patway	KEGG
ELAM	Diabetes_patway	KEGG
ELAM1	Diabetes_patway	KEGG
ESEL	Diabetes_patway	KEGG
LECAM2	Diabetes_patway	KEGG
PRKCA	Diabetes_patway	KEGG
AAG6	Diabetes_patway	KEGG
PKC-alpha	Diabetes_patway	KEGG
PKCA	Diabetes_patway	KEGG
PKCI+/-	Diabetes_patway	KEGG
PKCalpha	Diabetes_patway	KEGG
PRKACA	Diabetes_patway	KEGG
PLCD3	Diabetes_patway	KEGG
PLC-delta-3	Diabetes_patway	KEGG
TGFB1	Diabetes_patway	KEGG
CED	Diabetes_patway	KEGG
DPD1	Diabetes_patway	KEGG
IBDIMDE	Diabetes_patway	KEGG
LAP	Diabetes_patway	KEGG
TGF-beta1	Diabetes_patway	KEGG
TGFB	Diabetes_patway	KEGG
TGFbeta	Diabetes_patway	KEGG
AGTR1	Diabetes_patway	KEGG
AG2S	Diabetes_patway	KEGG
AGTR1B	Diabetes_patway	KEGG
AT1	Diabetes_patway	KEGG
AT1AR	Diabetes_patway	KEGG
AT1B	Diabetes_patway	KEGG
AT1BR	Diabetes_patway	KEGG
AT1R	Diabetes_patway	KEGG
AT2R1	Diabetes_patway	KEGG
HAT1R	Diabetes_patway	KEGG
CDKN1B	Diabetes_patway	KEGG
CDKN4	Diabetes_patway	KEGG
KIP1	Diabetes_patway	KEGG
MEN1B	Diabetes_patway	KEGG
MEN4	Diabetes_patway	KEGG
P27KIP1	Diabetes_patway	KEGG
FN1	Diabetes_patway	KEGG
CIG	Diabetes_patway	KEGG
ED-B	Diabetes_patway	KEGG
FINC	Diabetes_patway	KEGG
FN	Diabetes_patway	KEGG
FNZ	Diabetes_patway	KEGG
GFND	Diabetes_patway	KEGG
GFND2	Diabetes_patway	KEGG
LETS	Diabetes_patway	KEGG
MSF	Diabetes_patway	KEGG
SMDCF	Diabetes_patway	KEGG
AGT	Diabetes_patway	KEGG
ANHU	Diabetes_patway	KEGG
SERPINA8	Diabetes_patway	KEGG
hFLT1	Diabetes_patway	KEGG
TNF	Sarcopenia	Disgenet
IGF1	Sarcopenia	Disgenet
ATP6AP2	Sarcopenia	Disgenet
HSD11B1	Sarcopenia	Disgenet
MSTN	Sarcopenia	Disgenet
MYOG	Sarcopenia	Disgenet
TNNC2	Muscle	GeneOntology
ACTA2	Muscle	GeneOntology
GYS1	Muscle	GeneOntology
TNNI3	Muscle	GeneOntology
TNNT2	Muscle	GeneOntology
ACTA1	Muscle	GeneOntology
PYGM	Muscle	GeneOntology
TNNI1	Muscle	GeneOntology
ACTC1	Muscle	GeneOntology
TNNT1	Muscle	GeneOntology
TNNT3	Muscle	GeneOntology
ACTG2	Muscle	GeneOntology
TNNI2	Muscle	GeneOntology
MYH7	Muscle	GeneOntology
MYH1	Muscle	GeneOntology
PPP1R21	Muscle	GeneOntology
MYH13	Muscle	GeneOntology
MYH7B	Muscle	GeneOntology
MYH15	Muscle	GeneOntology
MYH11	Muscle	GeneOntology
MYH2	Muscle	GeneOntology
MYH14	Muscle	GeneOntology
MYH8	Muscle	GeneOntology
MYH6	Muscle	GeneOntology
MYO18B	Muscle	GeneOntology
MYO18A	Muscle	GeneOntology
MYH10	Muscle	GeneOntology
MYH9	Muscle	GeneOntology
MYH3	Muscle	GeneOntology
MYH4	Muscle	GeneOntology
URS00004DC390_9606	Muscle	GeneOntology
MUSK	Muscle	GeneOntology
CPT1B	Muscle	GeneOntology
PFKM	Muscle	GeneOntology
SPEG	Muscle	GeneOntology
MYLK	Muscle	GeneOntology
CLMN	Muscle	GeneOntology
SYNE3	Muscle	GeneOntology
ABRA	Muscle	GeneOntology
URS00004DAA89_9606	Muscle	GeneOntology
URS00002524E1_9606	Muscle	GeneOntology
PHKA1	Muscle	GeneOntology
MYLK2	Muscle	GeneOntology
MYLPF	Muscle	GeneOntology
PHKG1	Muscle	GeneOntology
MYL2	Muscle	GeneOntology
NACA	Muscle	GeneOntology
MYL1	Muscle	GeneOntology
PERM1	Muscle	GeneOntology
ldha4_human	Muscle	GeneOntology
GHR	Aging	GeneAge
GHRH	Aging	GeneAge
SHC1	Aging	GeneAge
POU1F1	Aging	GeneAge
PROP1	Aging	GeneAge
TP53	Aging	GeneAge
TERC	Aging	GeneAge
TERT	Aging	GeneAge
ATM	Aging	GeneAge
PLAU	Aging	GeneAge
ERCC2	Aging	GeneAge
ERCC8	Aging	GeneAge
WRN	Aging	GeneAge
LMNA	Aging	GeneAge
IGF1R	Aging	GeneAge
TXN	Aging	GeneAge
KL	Aging	GeneAge
E2F1	Aging	GeneAge
PTPN11	Aging	GeneAge
NFKB2	Aging	GeneAge
STAT5B	Aging	GeneAge
STAT3	Aging	GeneAge
STAT5A	Aging	GeneAge
NRG1	Aging	GeneAge
HDAC3	Aging	GeneAge
GH1	Aging	GeneAge
IL7R	Aging	GeneAge
IGF1	Aging	GeneAge
IGF2	Aging	GeneAge
INS	Aging	GeneAge
NGF	Aging	GeneAge
IRS1	Aging	GeneAge
PTPN1	Aging	GeneAge
IRS2	Aging	GeneAge
AKT1	Aging	GeneAge
PIK3CB	Aging	GeneAge
NGFR	Aging	GeneAge
HRAS	Aging	GeneAge
MYC	Aging	GeneAge
EGFR	Aging	GeneAge
ERBB2	Aging	GeneAge
INSR	Aging	GeneAge
NCOR1	Aging	GeneAge
NBN	Aging	GeneAge
JUND	Aging	GeneAge
IL2	Aging	GeneAge
PDGFB	Aging	GeneAge
EGF	Aging	GeneAge
IL2RG	Aging	GeneAge
FOS	Aging	GeneAge
PDGFRB	Aging	GeneAge
EPOR	Aging	GeneAge
SST	Aging	GeneAge
PRKCD	Aging	GeneAge
PPARA	Aging	GeneAge
RET	Aging	GeneAge
PLCG2	Aging	GeneAge
PEX5	Aging	GeneAge
TCF3	Aging	GeneAge
PARP1	Aging	GeneAge
BRCA1	Aging	GeneAge
PIN1	Aging	GeneAge
PTEN	Aging	GeneAge
CREBBP	Aging	GeneAge
HIF1A	Aging	GeneAge
UBB	Aging	GeneAge
RPA1	Aging	GeneAge
BLM	Aging	GeneAge
BCL2	Aging	GeneAge
S100B	Aging	GeneAge
VCP	Aging	GeneAge
POLG	Aging	GeneAge
IGFBP3	Aging	GeneAge
HSP90AA1	Aging	GeneAge
NR3C1	Aging	GeneAge
EGR1	Aging	GeneAge
VEGFA	Aging	GeneAge
ABL1	Aging	GeneAge
BRCA2	Aging	GeneAge
TOP2A	Aging	GeneAge
TOP2B	Aging	GeneAge
NFKB1	Aging	GeneAge
TOP1	Aging	GeneAge
RAD51	Aging	GeneAge
UBE2I	Aging	GeneAge
TNF	Aging	GeneAge
PDPK1	Aging	GeneAge
CEBPA	Aging	GeneAge
CEBPB	Aging	GeneAge
MXI1	Aging	GeneAge
TGFB1	Aging	GeneAge
ERCC6	Aging	GeneAge
STK11	Aging	GeneAge
EP300	Aging	GeneAge
APTX	Aging	GeneAge
PML	Aging	GeneAge
GSK3B	Aging	GeneAge
HTT	Aging	GeneAge
PRKCA	Aging	GeneAge
SSTR3	Aging	GeneAge
HELLS	Aging	GeneAge
APOC3	Aging	GeneAge
EEF2	Aging	GeneAge
ERCC3	Aging	GeneAge
TERF1	Aging	GeneAge
PRKDC	Aging	GeneAge
CAT	Aging	GeneAge
ERCC5	Aging	GeneAge
AR	Aging	GeneAge
GTF2H2	Aging	GeneAge
XRCC5	Aging	GeneAge
PCNA	Aging	GeneAge
FEN1	Aging	GeneAge
FAS	Aging	GeneAge
TERF2	Aging	GeneAge
XRCC6	Aging	GeneAge
POLD1	Aging	GeneAge
BAX	Aging	GeneAge
RB1	Aging	GeneAge
EMD	Aging	GeneAge
GRB2	Aging	GeneAge
FOXO3	Aging	GeneAge
FOXO1	Aging	GeneAge
HSF1	Aging	GeneAge
XPA	Aging	GeneAge
MSRA	Aging	GeneAge
RECQL4	Aging	GeneAge
SOD2	Aging	GeneAge
SOD1	Aging	GeneAge
FOXM1	Aging	GeneAge
COQ7	Aging	GeneAge
CACNA1A	Aging	GeneAge
LRP2	Aging	GeneAge
AIFM1	Aging	GeneAge
UCHL1	Aging	GeneAge
APP	Aging	GeneAge
APOE	Aging	GeneAge
A2M	Aging	GeneAge
SNCG	Aging	GeneAge
PRDX1	Aging	GeneAge
PON1	Aging	GeneAge
RELA	Aging	GeneAge
IL6	Aging	GeneAge
RGN	Aging	GeneAge
ATP5O	Aging	GeneAge
RAD52	Aging	GeneAge
TOP3B	Aging	GeneAge
ERCC1	Aging	GeneAge
SIRT1	Aging	GeneAge
HDAC1	Aging	GeneAge
HSPA9	Aging	GeneAge
GPX1	Aging	GeneAge
GSR	Aging	GeneAge
GSS	Aging	GeneAge
GSTA4	Aging	GeneAge
GSTP1	Aging	GeneAge
MT-CO1	Aging	GeneAge
HSPD1	Aging	GeneAge
HSPA1A	Aging	GeneAge
HSPA1B	Aging	GeneAge
PCMT1	Aging	GeneAge
MAPK8	Aging	GeneAge
YWHAZ	Aging	GeneAge
PTK2B	Aging	GeneAge
PTK2	Aging	GeneAge
IL7	Aging	GeneAge
MAPK14	Aging	GeneAge
FGFR1	Aging	GeneAge
SP1	Aging	GeneAge
FLT1	Aging	GeneAge
JUN	Aging	GeneAge
MED1	Aging	GeneAge
MAPK9	Aging	GeneAge
MAPK3	Aging	GeneAge
HMGB1	Aging	GeneAge
CCNA2	Aging	GeneAge
HMGB2	Aging	GeneAge
MAP3K5	Aging	GeneAge
TAF1	Aging	GeneAge
LMNB1	Aging	GeneAge
SDHC	Aging	GeneAge
FOXO4	Aging	GeneAge
HESX1	Aging	GeneAge
PIK3R1	Aging	GeneAge
BSCL2	Aging	GeneAge
AGPAT2	Aging	GeneAge
BMI1	Aging	GeneAge
EEF1A1	Aging	GeneAge
TFAP2A	Aging	GeneAge
BDNF	Aging	GeneAge
CREB1	Aging	GeneAge
ATF2	Aging	GeneAge
TBP	Aging	GeneAge
APEX1	Aging	GeneAge
HBP1	Aging	GeneAge
BUB1B	Aging	GeneAge
PTGS2	Aging	GeneAge
HSPA8	Aging	GeneAge
SIN3A	Aging	GeneAge
CDK1	Aging	GeneAge
TFDP1	Aging	GeneAge
DDIT3	Aging	GeneAge
POLA1	Aging	GeneAge
MAPT	Aging	GeneAge
CTGF	Aging	GeneAge
HDAC2	Aging	GeneAge
MAX	Aging	GeneAge
MXD1	Aging	GeneAge
MDM2	Aging	GeneAge
SUMO1	Aging	GeneAge
H2AFX	Aging	GeneAge
HOXB7	Aging	GeneAge
HOXC4	Aging	GeneAge
JAK2	Aging	GeneAge
ESR1	Aging	GeneAge
LEP	Aging	GeneAge
LEPR	Aging	GeneAge
NFKBIA	Aging	GeneAge
CLU	Aging	GeneAge
MTOR	Aging	GeneAge
GHRHR	Aging	GeneAge
CTNNB1	Aging	GeneAge
PSEN1	Aging	GeneAge
DLL3	Aging	GeneAge
CDKN2A	Aging	GeneAge
PPP1CA	Aging	GeneAge
DBN1	Aging	GeneAge
NOG	Aging	GeneAge
ELN	Aging	GeneAge
ATR	Aging	GeneAge
UCP3	Aging	GeneAge
ZMPSTE24	Aging	GeneAge
TP63	Aging	GeneAge
UCP2	Aging	GeneAge
POLB	Aging	GeneAge
GCLC	Aging	GeneAge
GCLM	Aging	GeneAge
SIRT6	Aging	GeneAge
BUB3	Aging	GeneAge
RAE1	Aging	GeneAge
PMCH	Aging	GeneAge
MLH1	Aging	GeneAge
CSNK1E	Aging	GeneAge
STUB1	Aging	GeneAge
PPM1D	Aging	GeneAge
CHEK2	Aging	GeneAge
PCK1	Aging	GeneAge
ARHGAP1	Aging	GeneAge
CDC42	Aging	GeneAge
ARNTL	Aging	GeneAge
CLOCK	Aging	GeneAge
HIC1	Aging	GeneAge
PAPPA	Aging	GeneAge
ADCY5	Aging	GeneAge
PPARGC1A	Aging	GeneAge
GPX4	Aging	GeneAge
UCP1	Aging	GeneAge
FGF23	Aging	GeneAge
EFEMP1	Aging	GeneAge
ERCC4	Aging	GeneAge
CETP	Aging	GeneAge
PPARG	Aging	GeneAge
AGTR1	Aging	GeneAge
CISD2	Aging	GeneAge
EEF1E1	Aging	GeneAge
EPS8	Aging	GeneAge
KCNA3	Aging	GeneAge
SIRT7	Aging	GeneAge
SLC13A1	Aging	GeneAge
SOCS2	Aging	GeneAge
TPP2	Aging	GeneAge
TP53BP1	Aging	GeneAge
SIRT3	Aging	GeneAge
NCOR2	Aging	GeneAge
SUN1	Aging	GeneAge
BAK1	Aging	GeneAge
IGFBP2	Aging	GeneAge
PYCR1	Aging	GeneAge
TP73	Aging	GeneAge
CNR1	Aging	GeneAge
NFE2L2	Aging	GeneAge
CDKN1A	Aging	GeneAge
PDGFRA	Aging	GeneAge
PIK3CA	Aging	GeneAge
C1QA	Aging	GeneAge
CDKN2B	Aging	GeneAge
EIF5A2	Aging	GeneAge
MIF	Aging	GeneAge
DGAT1	Aging	GeneAge
MT1E	Aging	GeneAge
FGF21	Aging	GeneAge
HTRA2	Aging	GeneAge
GSK3A	Aging	GeneAge
NUDT1	Aging	GeneAge
IKBKB	Aging	GeneAge
SQSTM1	Aging	GeneAge
CDK7	Aging	GeneAge
GRN	Aging	GeneAge
SERPINE1	Aging	GeneAge
SPRTN	Aging	GeneAge
RICTOR	Aging	GeneAge
CTF1	Aging	GeneAge
TRAP1	Aging	GeneAge
TRPV1	Aging	GeneAge
NFE2L1	Aging	GeneAge
IFNB1	Aging	GeneAge
GDF11	Aging	GeneAge